1;N;1;C;1;2;CC;1;1
N;N;N;2;2;C;1;N;1
CC;C;P;1;2;3;3;N;2
N;1;X;X;X;X;C;1;3
3;1;1;CN;1;1;1;1;3
3;3;3;3;N;3;3;3;C
N;1;X;X;X;X;C;1;CC
1;N;1;C;1;2;CC;1;1